NO txtures/pedro_map/pedro1.xpm
SO txtures/pedro_map/pedro2.xpm
WE txtures/pedro_map/pedro3.xpm
EA txtures/pedro_map/pedro4.xpm
F 88,57,39
C 58,58,58
   
1111111111111111
1000000110000001
1001000000000001
1000000000010001
1000000000011111
100000000000000111
11100000hi!!0000001
100000000001100111
1000000000000001
1001100000000001
1000000000110001
1000000000100001
10011110001000W1
1111111111111111