NO txtures/pedro_map/pedro1.xpm
SO txtures/pedro_map/pedro2.xpm
WE txtures/pedro_map/pedro3.xpm
EA txtures/pedro_map/pedro4.xpm
F 88,57,39
C 58,58,58
   
11111
1W001
10001
10001
100E1
11111