NO txtures/cat_map/cat1.xpm
SO txtures/cat_map/cat2.xpm
WE txtures/cat_map/cat3.xpm
EA txtures/cat_map/cat4.xpm
F 88,57,39
C 19,58,58
1111111111111111111
1000000000000000001
1000000000000000001
1000000000000000001
1000000000001000001
1000000000000100001
100000000N000000001
1000000001000000001
1000000000000000001
1000000000000000001
1000000000000100001
1000000000000000001
1000000000000000001
1111111111111111111
