NO txtures/cat_map/cat1.jpg
SO txtures/cat_map/cat2.xpm
WE txtures/cat_map/cat3.xpm
EA txtures/cat_map/cat4.xpm
F 88,57,39
C 58,58,58




11111
10001
10N01
10001
11111



   