NO txtures/pedro_map/pedro1.xpm
SO txtures/pedro_map/pedro1.xpm
WE txtures/pedro_map/pedro1.xpm
EA txtures/pedro_map/pedro1.xpm
F 88,57,39
C 0,240,2



1111
10W1
1111



   