NO txtures/pedro1.xpm
SO txtures/pedro2.xpm
WE txtures/pedro3.xpm
EA txtures/pedro4.xpm
F 220,100,0
C 225,30,0

11111111
10000001
10010001
100N0001
10000001
10000001
11111111
