NO txtures/pedro_map/pedro1.xpm
SO txtures/pedro_map/pedro2.xpm
WE txtures/pedro_map/pedro3.xpm
EA txtures/pedro_map/pedro4.xpm
F 88,57,39
C 58,58,58

1111111111111111111
1000000000000000001
1000000000000000001
1000000000000000001
1000000000000000001
1000000000000000001
1000000000000000001
1000000001000000001
100000000E000000001
1000000000000000001
1000000000000000001
1000000000000000001
1000000000000000001
1111111111111111111
