NO txtures/warcat_map/warcat1.xpm
SO txtures/warcat_map/warcat2.xpm
WE txtures/warcat_map/warcat3.xpm
EA txtures/warcat_map/warcat4.xpm
F 88,57,39
C 58,58,58
        1111111111111111111111111
        1000000000110000000000001
        1011000001110000000000001
        1001000000000000000000001
111111111011000001110000000000001
100000000011000001110111110111111
11110111111111011100000010001
11110111111111011101010010001
11000000110001011100000010001
10000000000010001100000010001
10000000000000001101010010001
11000001110101011111011110N0111
11110111 1110101 101111010001
11111111 1111111 111111111111


